Everyone else in the kitchen seems to have dissapeared. There is one meal left that needs to be completed. You know that you need to find the manager. You remember that he stays in the pass. You need to get the special menu from him. The manager also has things like the key for the wine cellar so you should ask him ABOUT things like that.

Dinner Service
An Interactive Fiction by Jalen Toyama
Release 1 / Serial number 190422 / Inform 7 build 6M62 (I6/v6.33 lib 6/12N) SD

Hot station
The main cooking area of the kitchen. There is an eight burner gas stove on one side and a pair of commercial ovens on the other. There is a portion of pomme puree keeping warm on the stove and there is a ribeye resting on the counter. The plating station is to the south and the prep station is to the west.

You can see Sous vide ribeye and Pomme puree here.

I beg your pardon?

>e
Hot station
You can see Sous vide Ribeye and Pomme puree here.

>s
Plating station
You can see Balsamic dressing, Walnuts, Cognac butter sauce and Whole cane sugar here.

>s
Pass
You can see a Restaurant manager here.

I beg your pardon?

* * *

I beg your pardon?

* * *

>e
You can't go that way.

>e
You can't go that way.

>s
Plating station
You can see Balsamic dressing, Walnuts, Cognac butter sauce and Whole cane sugar here.

* * *

>s
Pass
You can see a Restaurant manager here.

>s
You can't go that way.

>ask manager for cellar key
The Restaurant manager has better things to do.

* * *

>s
You can't go that way.

>ask for key
You can't see any such thing.

>ask manager for key
"excuse me, could I have the wine cellar key?" you ask. 

 "Here" he replies as he tosses me the key

>n
Plating station
You can see Balsamic dressing, Walnuts, Cognac butter sauce and Whole cane sugar here.

>n
Hot station
You can see Sous vide Ribeye and Pomme puree here.

>w
Prep station

>w
Wiine Cellar

>x wine case
I only understood you as far as wanting to examine the Wine cellar key.

>open wine case
I only understood you as far as wanting to open the Wine cellar key.

* * *

>s
You can't go that way.

>s
You can't go that way.

>ask manager for key
"excuse me, could I have the wine cellar key?" you ask. 

 "Here" he replies as he tosses me the key

>i
You are carrying:
  a Wine cellar key

I beg your pardon?

I beg your pardon?

>n
Plating station
You can see Balsamic dressing, Walnuts, Cognac butter sauce and Whole cane sugar here.

* * *

>w
Prep station

>s
cold station
You can see Roasted beets and Vanilla custard here.

>w
You can't go that way.

>n
Prep station

>w
Wiine Cellar

* * *

>s
You can't go that way.

>talk to manager
That's not a verb I recognise.

* * *

>s
Pass
You can see a Restaurant manager here.

>talk to manager
"What do you want!?" he snapps 

 "If you need something ask for it."

>ask for key
You can't see any such thing.

* * *

>s
Pass
You can see a Restaurant manager here.

>x manager
A rather short french man in his late thirties. He is very tightly wound and he takes his job very seriously.

* * *

>s
Plating station
You can see Balsamic dressing, Walnuts, Cognac butter sauce and Whole cane sugar here.

>take
(the Beet Salad description)
That's hardly portable.

* * *

>s
Plating station
You can see Balsamic dressing, Walnuts, Cognac butter sauce and Whole cane sugar here.

>x beet salad
Roasted beet salad: ROASTED BEETS tossed with youg SPRING GREENS topped with a BALSAMIC dressing, toasted WALNUTS and GOAT CHEESE.

* * *

>n
You can't go that way.

>w
Prep station

>e
Hot station
You can see Sous-vide Ribeye and Pomme puree here.

>s
Plating station
You can see Balsamic dressing, Walnuts, Butter sauce, Whole cane sugar and a counter (on which is a prep plate) here.

>s
Pass
You can see a Restaurant manager and a pickup table here.

>talk
(to the Restaurant manager)
"What do you want!?" he snapps 

 "If you need something ask for it."

>ask about menu
You can't see any such thing.

>ask manager about menu
"Hey, whats the special menu for today?" you ask. 

 "You should already know it" he snaps back as he reaches into his jacket pocket and hands you the menu. "Here."

>examine menu
Printed in a small font it reads: App is a roasted beet salad. Dinner is a ribeye steak. Dessert is a creme brulee. The first two dishes will be served with a fine red wine and dessert will be served with champagne. Obviously, first app, then dinner, then desert.

>n
Plating station
You can see Balsamic dressing, Walnuts, Butter sauce, Whole cane sugar and a counter (on which is a prep plate) here.

>x description
Which do you mean, the Beet Salad description, the Ribeye description or the Creme Brulee description?

>Ribeye description
A sous vide RIBEYE, accompanied by POMME PUREE, and sauted HERICOTS VERTS topped with a BUTTER SAUCE.

>n
Hot station
You can see Sous-vide Ribeye and Pomme puree here.

>n
You can't go that way.

>take both
Sous-vide Ribeye: Taken.
Pomme puree: Taken.

>e
You can't go that way.

I beg your pardon?

>e
You can't go that way.

>w
Prep station

>n
Walk-in
You can see spring greens, Goat cheese, Hericot verts and Mixed seasonal fruit here.

>take verts
Taken.

>s
Prep station

>s
cold station
You can see Roasted beets and Vanilla custard here.

>e
Plating station
You can see Balsamic dressing, Walnuts, Butter sauce, Whole cane sugar and a counter (on which is a prep plate) here.

>take Butter sause
I only understood you as far as wanting to take Butter sauce.

>take Butter sauce
Taken.

>put on plate
(first taking the prep plate)
That's fixed in place.

>Put ribeye on plate
(Sous-vide Ribeye on the prep plate)
You put Sous-vide Ribeye on the prep plate.

>put butter sauce on plate
You put Butter sauce on the prep plate.

>put verts on plate
You put Hericot verts on the prep plate.

>put the pomme on plate
You put Pomme puree on the prep plate.

>plate dinner
You put together Pomme puree, Hericot verts, Butter sauce and Sous-vide Ribeye.

You now have a Sous vide Ribeye properly plated. Now take it to the pass!

>examine menu
Printed in a small font it reads: App is a roasted beet salad. Dinner is a ribeye steak. Dessert is a creme brulee. The first two dishes will be served with a fine red wine and dessert will be served with champagne. Obviously, first app, then dinner, then desert.

>x creme brulee description
Madagascar vanilla bean CUSTARD bruleed with whole CANE SUGAR and topped with mixed seasonal FRUIT.

>w
cold station
You can see Roasted beets and Vanilla custard here.

>take Vanilla custard
Taken.

>e
Plating station
You can see Balsamic dressing, Walnuts, Whole cane sugar and a counter (on which is a prep plate) here.

>take whole cane sugar
Taken.

>w
cold station
You can see Roasted beets here.

>n
Prep station

>n
Walk-in
You can see spring greens, Goat cheese and Mixed seasonal fruit here.

>take Mixed seasonal fruit
Taken.

>s
Prep station

>s
cold station
You can see Roasted beets here.

>e
Plating station
You can see Balsamic dressing, Walnuts and a counter (on which is a prep plate) here.

>s
Pass
You can see a Restaurant manager and a pickup table here.

>ask manager about key
"Excuse me, could I have the wine cellar key?", you ask. 

 "Here" he replies as he tosses you the key.

>n
Plating station
You can see Balsamic dressing, Walnuts and a counter (on which is a prep plate) here.

>w
cold station
You can see Roasted beets here.

* * *

>n
Prep station

>w
Wine Cellar

>unlock wine cage
I didn't understand that sentence.

>unlock wine case
What do you want to unlock Wine case with?

>key
You unlock Wine case.

>open wine case
You open Wine case, revealing Fine white wine, Fine red wine and Champagne.

>take Champagne
Taken.

>e
Prep station

>s
cold station
You can see Roasted beets here.

* * *

>e
Plating station
You can see Balsamic dressing, Walnuts and a counter (on which is a prep plate) here.

>plate Champagne
I only understood you as far as wanting to plate.

>put Champagne
What do you want to put Champagne in?

>on plate
You can't see any such thing.

>put Champagne on plate
You put Champagne on the prep plate.

>put Custard on plate
You put Vanilla custard on the prep plate.

>put fruit on plate
You put Mixed seasonal fruit on the prep plate.

>put sugar on plate
You put Whole cane sugar on the prep plate.

>plate desert
I only understood you as far as wanting to plate.

>plate dessert
You put together Whole cane sugar, Mixed seasonal fruit, Vanilla custard and Champagne.

You now have a Vanilla creme brulee properly plated. Now take it to the pass!

>s
Pass
You can see a Restaurant manager and a pickup table here.

>n
Plating station
You can see Balsamic dressing, Walnuts and a counter (on which is a prep plate) here.

>n
Hot station

>n
You can't go that way.

* * *

>plate app
This is not a correct combination for any of the special menu dishes. 
You should try again.

* * *

>s
Plating station
The final place in the kitchen where the food is handled before it is sent out to the guest. This is where you will find sauces and most garnishes. there is a counter with plates where dishes can be PLATED with the correct components. There are descriptions for the roasted beet salad, ribeye, and creme brulee here. the hot station is to the north. The break room is to the east. The cold station is to the west.

You can see Balsamic dressing, Walnuts, Butter sauce, Whole cane sugar and a counter (on which is a prep plate) here.

>e
Break room
What is basically a closet is the break room.

You can see a note here.

>s
Pass
You can see a Restaurant manager here.

* * *

>talk to manager
"What do you want!?" he snapps 

 "If you need something ask for it."

>ask manager for key
"excuse me, could I have the wine cellar key?" you ask. 

 "Here" he replies as he tosses me the key

* * *

>e
Break room
What is basically a closet is the break room.

You can see a note here.

>take note
Taken.

>x note
A small hand written note that reads: if you forget how to make a certain dish just look at the descriptions in the plating station. To PLATE a dish obviously you need to have all the components on the plate.

* * *

>s
Plating station
The final place in the kitchen where the food is handled before it is sent out to the guest. This is where you will find sauces and most garnishes. there is a counter with plates where dishes can be PLATED with the correct components. There are descriptions for the roasted beet salad, ribeye, and creme brulee here. the hot station is to the north. The break room is to the east. The cold station is to the west.

You can see Balsamic dressing, Walnuts, Butter sauce, Whole cane sugar and a counter (on which is a prep plate) here.

>s
Pass
You can see a Restaurant manager and a pickup table here.

>Converse with Manager
You can't see any such thing.

>x manager
You see nothing special about the Restaurant manager.

* * *

>s
Pass
You can see a Restaurant manager and a pickup table here.

>Talk to Restaurant manager
"What do you want!?" he snapps 

 "If you need something ask for it."

>ask Restaurant manager for special menu
You can't see any such thing.

>ask manager about menu
"Hey, whats the special menu for today?" you ask. 

 "You should already know it" he snaps back as he reaches into his jacket pocket and hands you the menu. "Here."

>look at menu
Printed in a small font it reads: App is a roasted beet salad. Dinner is a ribeye steak. Dessert is a creme brulee. The first two dishes will be served with a fine red wine and dessert will be served with champagne. Obviously, first app, then dinner, then desert.

>ask manager for key
The Restaurant manager has better things to do.

>ask manager about key
"Excuse me, could I have the wine cellar key?", you ask. 

 "Here" he replies as he tosses you the key.

>n
Plating station
You can see Balsamic dressing, Walnuts, Butter sauce, Whole cane sugar and a counter (on which is a prep plate) here.

>s
Pass
You can see a Restaurant manager and a pickup table here.

>w
You can't go that way.

>e
You can't go that way.

>n
Plating station
You can see Balsamic dressing, Walnuts, Butter sauce, Whole cane sugar and a counter (on which is a prep plate) here.

>n
Hot station
You can see Sous-vide Ribeye and Pomme puree here.

>s
Plating station
You can see Balsamic dressing, Walnuts, Butter sauce, Whole cane sugar and a counter (on which is a prep plate) here.

>x room
You can't see any such thing.

>x plating station
You can't see any such thing.

>x Plating station
You can't see any such thing.

>x description
Which do you mean, the Beet Salad description, the Ribeye description or the Creme Brulee description?

>x beet salad description
Roasted beet salad: ROASTED BEETS tossed with youg SPRING GREENS topped with a BALSAMIC dressing, toasted WALNUTS and GOAT CHEESE.

>s
Pass
You can see a Restaurant manager and a pickup table here.

>n
Plating station
You can see Balsamic dressing, Walnuts, Butter sauce, Whole cane sugar and a counter (on which is a prep plate) here.

>take walnuts
Taken.

>take balsamic dressing
Taken.

>n
Hot station
You can see Sous-vide Ribeye and Pomme puree here.

>s
Plating station
You can see Butter sauce, Whole cane sugar and a counter (on which is a prep plate) here.

>s
Pass
You can see a Restaurant manager and a pickup table here.

>n
Plating station
You can see Butter sauce, Whole cane sugar and a counter (on which is a prep plate) here.

>n
Hot station
You can see Sous-vide Ribeye and Pomme puree here.

>w
Prep station

>w
Wine Cellar

>unlock wine case
What do you want to unlock Wine case with?

* * *

>open wine case
You open Wine case, revealing Fine white wine, Fine red wine and Champagne.

>drink white wine
There's nothing suitable to drink here.

>take red wine
Taken.

>take champagne
Taken.

>e
Prep station

>n
Walk-in
You can see spring greens, Goat cheese, Hericot verts and Mixed seasonal fruit here.

>take goat cheese
Taken.

>take spring greens
Taken.

>i
You are carrying:
  spring greens
  Goat cheese
  Champagne
  Fine red wine
  Balsamic dressing
  Walnuts
  a Wine cellar key
  a Special Menu

>x special menu
You can't see any such thing.

>x
What do you want to examine?

>special menu
You can't see any such thing.

>x a special menu
You can't see any such thing.

>x menu
Printed in a small font it reads: App is a roasted beet salad. Dinner is a ribeye steak. Dessert is a creme brulee. The first two dishes will be served with a fine red wine and dessert will be served with champagne. Obviously, first app, then dinner, then desert.

>n
You can't go that way.

>w
You can't go that way.

* * *

>e
You can't go that way.

>s
Prep station

* * *

>s
cold station
You can see Roasted beets and Vanilla custard here.

>take roasted beets
Taken.

>take vanilla custard
Taken.

>s
You can't go that way.

>e
Plating station
You can see Butter sauce, Whole cane sugar and a counter (on which is a prep plate) here.

>put spring greens onplate
I didn't understand that sentence.

>put spring greens on plate
You put spring greens on the prep plate.

>put roasted beets on plate
You put Roasted beets on the prep plate.

>put goat cheese on plate
You put Goat cheese on the prep plate.

>put balsamic on plate
You put Balsamic dressing on the prep plate.

>put walnuts on plate
You put Walnuts on the prep plate.

>put red wine on plate
You put Fine red wine on the prep plate.

>plate app
This is not a correct combination for any of the special menu dishes. 
You should try again.

>x plzte
You can't see any such thing.

>x plate
On the prep plate are Fine red wine, Walnuts, Balsamic dressing, Goat cheese, Roasted beets and spring greens.

>plate app
This is not a correct combination for any of the special menu dishes. 
You should try again.

>prep app
That's not a verb I recognise.

>n
Hot station
You can see Sous-vide Ribeye and Pomme puree here.

>take all
Sous-vide Ribeye: Taken.
Pomme puree: Taken.

>e
You can't go that way.

* * *

>w
Prep station

>n
Walk-in
You can see Hericot verts and Mixed seasonal fruit here.

>take all
Hericot verts: Taken.
Mixed seasonal fruit: Taken.

>s
Prep station

>s
cold station

>s
You can't go that way.

>w
You can't go that way.

>e
Plating station
You can see Butter sauce, Whole cane sugar and a counter (on which is a prep plate (on which are Fine red wine, Walnuts, Balsamic dressing, Goat cheese, Roasted beets and spring greens)) here.

>take all
Butter sauce: Taken.
Whole cane sugar: Taken.
Fine red wine: Taken.
Walnuts: Taken.
Balsamic dressing: Taken.
Goat cheese: Taken.
Roasted beets: Taken.
spring greens: Taken.

>n
Hot station

* * *

>n
You can't go that way.

>e
You can't go that way.

* * *

>w
Prep station

>n
Walk-in

>i
You are carrying:
  spring greens
  Roasted beets
  Goat cheese
  Balsamic dressing
  Walnuts
  Fine red wine
  Whole cane sugar
  Butter sauce
  Mixed seasonal fruit
  Hericot verts
  Pomme puree
  Sous-vide Ribeye
  Vanilla custard
  Champagne
  a Wine cellar key
  a Special Menu

>n
You can't go that way.

>s
Prep station

>e
Hot station

>s
Plating station
You can see a counter (on which is a prep plate) here.

>s
Pass
You can see a Restaurant manager and a pickup table here.

>n
Plating station
You can see a counter (on which is a prep plate) here.

>put all on plate
spring greens: Done.
Roasted beets: Done.
Goat cheese: Done.
Balsamic dressing: Done.
Walnuts: Done.
Fine red wine: Done.
Whole cane sugar: Done.
Butter sauce: Done.
Mixed seasonal fruit: Done.
Hericot verts: Done.
Pomme puree: Done.
Sous-vide Ribeye: Done.
Vanilla custard: Done.
Champagne: Done.
Wine cellar key: Done.
Special Menu: Done.

>plate inner
I only understood you as far as wanting to plate.

>plate dinner
This is not a correct combination for any of the special menu dishes. 
You should try again.

>take all
Special Menu: Taken.
Wine cellar key: Taken.
Champagne: Taken.
Vanilla custard: Taken.
Sous-vide Ribeye: Taken.
Pomme puree: Taken.
Hericot verts: Taken.
Mixed seasonal fruit: Taken.
Butter sauce: Taken.
Whole cane sugar: Taken.
Fine red wine: Taken.
Walnuts: Taken.
Balsamic dressing: Taken.
Goat cheese: Taken.
Roasted beets: Taken.
spring greens: Taken.

>put verts on plate
You put Hericot verts on the prep plate.

>put ribeye on plate
(Sous-vide Ribeye on the prep plate)
You put Sous-vide Ribeye on the prep plate.

>put sauce on plate
You put Butter sauce on the prep plate.

>put pomme on plate
You put Pomme puree on the prep plate.

>plate dinner
You put together Pomme puree, Butter sauce, Sous-vide Ribeye and Hericot verts.

You now have a Sous vide Ribeye properly plated. Now take it to the pass!

>undo
Plating station
[Previous turn undone.]

>x plate
On the prep plate are Pomme puree, Butter sauce, Sous-vide Ribeye and Hericot verts.

>plate dinner
You put together Pomme puree, Butter sauce, Sous-vide Ribeye and Hericot verts.

You now have a Sous vide Ribeye properly plated. Now take it to the pass!

>s
Pass
You can see a Restaurant manager and a pickup table here.

>i
You are carrying:
  Sous vide Ribeye
  spring greens
  Roasted beets
  Goat cheese
  Balsamic dressing
  Walnuts
  Fine red wine
  Whole cane sugar
  Mixed seasonal fruit
  Vanilla custard
  Champagne
  a Wine cellar key
  a Special Menu

>put ribeye on table
You can't see any such thing.

>put on pickup table
(first taking the pickup table)
That's fixed in place.

>put ribeye on pickup table
You can't see any such thing.

* * *

>s
Pass
You can see a Restaurant manager and a pickup table here.

>aks manager about key
That's not a verb I recognise.

>ask manager about key
"Excuse me, could I have the wine cellar key?", you ask. 

 "Here" he replies as he tosses me the key.

>ask manager about menu
"Hey, whats the special menu for today?" you ask. 

 "You should already know it" he snaps back as he reaches into his jacket pocket and hands me the menu. "Here."

>i
You are carrying:
  a Special Menu
  a Wine cellar key

>x key
A case made from wood and glass pannels. Inside are the best and mose expensive wines in the restaurant.

* * *

>s
Pass
You can see a Restaurant manager and a pickup table here.

>ask about menu
You can't see any such thing.

>ask manager about menu
"Hey, whats the special menu for today?" you ask. 

 "You should already know it" he snaps back as he reaches into his jacket pocket and hands me the menu. "Here."

>x manu
You can't see any such thing.

>x menu
Printed in a small font it reads: App is a roasted beet salad. Dinner is a ribeye steak. Dessert is a creme brulee. The first two dishes will be served with a fine red wine and dessert will be served with champagne.

* * *

>s
Pass
You can see a Restaurant manager and a pickup table here.

>ask manager about cellar key
"Excuse me, could I have the wine cellar key?", you ask. 

 "Here" he replies as he tosses me the key.

>i
You are carrying:
  a Wine cellar key

>ask manager about special menu
There is no reply.

>x manager
A rather short french man in his late thirties. He is very tightly wound and he takes his job very seriously.

* * *

>s
Pass
You can see a Restaurant manager and a pickup table here.

>ask manager about food
There is no reply.

>ask manager about food
There is no reply.

>ask manager
(for the Restaurant manager)
(the Restaurant manager first taking the Restaurant manager)
The Restaurant manager has better things to do.

>ask manager about key
"Excuse me, could I have the wine cellar key?", you ask. 

 "Here" he replies as he tosses me the key.

* * *

>s
Pass
You can see a Restaurant manager and a pickup table here.

>ask manager about key
"Excuse me, could I have the wine cellar key?", you ask. 

 "Here" he replies as he tosses me the key.

>x key
You see nothing special about the Wine cellar key.

>n
Plating station
You can see Balsamic dressing, Walnuts, Cognac butter sauce, Whole cane sugar and a counter (on which is a final plate) here.

>w
cold station
You can see Roasted beets and Vanilla custard here.

>w
You can't go that way.

* * *

>w
Wine Cellar

>x case
A case made from wood and glass pannels. Inside are the best and mose expensive wines in the restaurant.

>unlock case with key
You unlock Wine case.

>open case
You open Wine case, revealing Fine white wine, Fine red wine and Champagne.

>take champagne
Taken.

>x champagne
You see nothing special about Champagne.

* * *

>s
Pass
You can see a Restaurant manager and a pickup table here.

>ask manager about menu
"Hey, whats the special menu for today?" you ask. 

 "You should already know it" he snaps back as he reaches into his jacket pocket and hands me the menu. "Here."

>ask manager about menu
The manager seems angry and says "I already gave you the special menu now go do what your payed for".

* * *

>ask manager about menu
"Hey, whats the special menu for today?" you ask. 

 "You should already know it" he snaps back as he reaches into his jacket pocket and hands me the menu. "Here."

>i
You are carrying:
  a Special Menu

>x manu
You can't see any such thing.

>x manu
You can't see any such thing.

>x menu
You see nothing special about the Special Menu.

* * *

>s
Pass
You can see a Restaurant manager and a pickup table here.

>ask manager for cellar key
The Restaurant manager has better things to do.

>ask manager about key
"excuse me, could I have the wine cellar key?" you ask. 

 "Here" he replies as he tosses me the key

* * *

>s
Pass
You can see a Restaurant manager and a pickup table here.

>ask manager for key
The Restaurant manager has better things to do.

>ask manager about key
"Excuse me, could I have the wine cellar key?", you ask. 

 "Here" he replies as he tosses me the key.

>ask manager about key
The manager seems angry and says "I already gave you the key".

* * *

>ask manager for key
The Restaurant manager has better things to do.

>ask manager about wine cellar key
There is no reply.

>ask Manager for key
The Restaurant manager has better things to do.

>talk to manager
You can't see any such thing.

>Talk to Manager
You can't see any such thing.

* * *

>ask manager for key
The Restaurant manager has better things to do.

>ask manager baout key
I didn't understand that sentence.

>ask manager about key
"Excuse me, could I have the wine cellar key?", you ask. 

 "Here" he replies as he tosses you the key.

* * *

>s
Pass
You can see a Restaurant manager and a pickup table here.

>s
You can't go that way.

>x table
You see nothing special about the pickup table.

* * *

>s
Pass
You can see a Restaurant manager and a pickup table here.

>talk to manager
"What do you want!?" he snapps 

 "If you need something ask for it."

>Talk to Manager
You can't see any such thing.

>ask manager
(for the Restaurant manager)
(the Restaurant manager first taking the Restaurant manager)
The Restaurant manager has better things to do.

>x Restaurant manager
You see nothing special about the Restaurant manager.

>take key
That seems to belong to the Restaurant manager.

>take maue
You can't see any such thing.

>steal key
That's not a verb I recognise.

>take key
That seems to belong to the Restaurant manager.

>ask manager about cellar key]
There is no reply.

>ask manager about cellar key
There is no reply.

* * *

>talk to manager
"What do you want!?" he snapps 

 "If you need something ask for it."

>ask manager about key
"Excuse me, could I have the wine cellar key?", you ask. 

 "Here" he replies as he tosses me the key.

>ask manager for food
You can't see any such thing.

>ask manager about
I didn't understand that sentence.

>ask manager about menu
"Hey, whats the special menu for today?" you ask. 

 "You should already know it" he snaps back as he reaches into his jacket pocket and hands me the menu. "Here."

* * *

>s
Pass
You can see a Restaurant manager and a pickup table here.

>x manageer
You can't see any such thing.

>x manager
You see nothing special about the Restaurant manager.

>talk to manager
You can't see any such thing.

* * *

>s
Pass
You can see a Restaurant manager and a pickup table here.

>x manager
A rather short french man in his late thirties. He is very tightly wound and he takes his job very seriously.

>talk to manager
"What do you want!?" he snapps 

 "If you need something ask for it."

>ask manager for cellar key
The Restaurant manager has better things to do.

* * *

>talk to manager
"What do you want!?" he snapps 

 "If you need something ask for it."

>ask manager for wine cellar key
The Restaurant manager has better things to do.

* * *

>s
Plating station
The final place in the kitchen where the food is handled before it is sent out to the guest. This is where you will find sauces and most garnishes. there is a counter with plates where dishes can be PLATED with the correct components. There are descriptions for the roasted beet salad, ribeye, and creme brulee here. the hot station is to the north. The break room is to the east. The cold station is to the west.

You can see Balsamic dressing, Walnuts, Butter sauce, Whole cane sugar and a counter (on which is a prep plate) here.

>w
cold station
The part of the kitchen where work not involving heat is done. It is also a place for prepared components of dishes to be held until they are needed. The prep station is to the north. The plating station is to the east.

You can see Roasted Beets and Vanilla custard here.

>w
You can't go that way.

>e
Plating station
The final place in the kitchen where the food is handled before it is sent out to the guest. This is where you will find sauces and most garnishes. there is a counter with plates where dishes can be PLATED with the correct components. There are descriptions for the roasted beet salad, ribeye, and creme brulee here. the hot station is to the north. The break room is to the east. The cold station is to the west.

You can see Balsamic dressing, Walnuts, Butter sauce, Whole cane sugar and a counter (on which is a prep plate) here.

>e
Break room

* * *

>take all
Sous vide ribeye: Taken.
Pomme puree: Taken.

>e
You can't go that way.

* * *

>w
Prep station

>n
Walk-in
You can see Young spring greens, Goat cheese, Hericot verts and Mixed seasonal fruit here.

>take all
Young spring greens: Taken.
Goat cheese: Taken.
Hericot verts: Taken.
Mixed seasonal fruit: Taken.

>s
Prep station

* * *

>s
cold station
You can see Roasted beets and Vanilla custard here.

>take all
Roasted beets: Taken.
Vanilla custard: Taken.

>e
Plating station
You can see Balsamic dressing, Walnuts, Cognac butter sauce, Whole cane sugar and a counter (on which is a prep plate) here.

>take all
Balsamic dressing: Taken.
Walnuts: Taken.
Cognac butter sauce: Taken.
Whole cane sugar: Taken.

>s
Pass
You can see a Restaurant manager here.

>ask manager about key
"Excuse me, could I have the wine cellar key?", you ask. 

 "Here" he replies as he tosses me the key.

>e
You can't go that way.

>n
Plating station
You can see a counter (on which is a prep plate) here.

>w
cold station

>w
You can't go that way.

* * *

>w
Wine Cellar

>unlock case with key
You unlock Wine case.

* * *

>open case
You open Wine case, revealing Fine white wine, Fine red wine and Champagne.

>take all
Fine white wine: Taken.
Fine red wine: Taken.
Champagne: Taken.

>e
Prep station

>s
cold station

>e
Plating station
You can see a counter (on which is a prep plate) here.

>e
Break room

>s
You can't go that way.

>w
Plating station
You can see a counter (on which is a prep plate) here.

>s
Pass
You can see a Restaurant manager here.

>n
Plating station
You can see a counter (on which is a prep plate) here.

>prep
That's not a verb I recognise.

>prep app
That's not a verb I recognise.

>plat eapp
That's not a verb I recognise.

>plate app
This is not a correct combination for any of the special menu dishes. 
You should try again.

>put all on counter
Champagne: Done.
Fine red wine: Done.
Fine white wine: Done.
Wine cellar key: Done.
Whole cane sugar: Done.
Cognac butter sauce: Done.
Walnuts: Done.
Balsamic dressing: Done.
Vanilla custard: Done.
Roasted beets: Done.
Mixed seasonal fruit: Done.
Hericot verts: Done.
Goat cheese: Done.
Young spring greens: Done.
Pomme puree: Done.
Sous vide Ribeye: Done.

>plate app
This is not a correct combination for any of the special menu dishes. 
You should try again.

>take all
Sous vide Ribeye: Taken.
Pomme puree: Taken.
Young spring greens: Taken.
Goat cheese: Taken.
Hericot verts: Taken.
Mixed seasonal fruit: Taken.
Roasted beets: Taken.
Vanilla custard: Taken.
Balsamic dressing: Taken.
Walnuts: Taken.
Cognac butter sauce: Taken.
Whole cane sugar: Taken.
Wine cellar key: Taken.
Fine white wine: Taken.
Fine red wine: Taken.
Champagne: Taken.

>put all on plate
Champagne: Done.
Fine red wine: Done.
Fine white wine: Done.
Wine cellar key: Done.
Whole cane sugar: Done.
Cognac butter sauce: Done.
Walnuts: Done.
Balsamic dressing: Done.
Vanilla custard: Done.
Roasted beets: Done.
Mixed seasonal fruit: Done.
Hericot verts: Done.
Goat cheese: Done.
Young spring greens: Done.
Pomme puree: Done.
Sous vide Ribeye: Done.

>x plate
On the prep plate are Sous vide Ribeye, Pomme puree, Young spring greens, Goat cheese, Hericot verts, Mixed seasonal fruit, Roasted beets, Vanilla custard, Balsamic dressing, Walnuts, Cognac butter sauce, Whole cane sugar, a Wine cellar key, Fine white wine, Fine red wine and Champagne.

>plate app
This is not a correct combination for any of the special menu dishes. 
You should try again.

>plate dinner
This is not a correct combination for any of the special menu dishes. 
You should try again.

>plate
This is not a correct combination for any of the special menu dishes. 
You should try again.

>eat
(the counter)
That's plainly inedible.

>take all
Sous vide Ribeye: Taken.
Pomme puree: Taken.
Young spring greens: Taken.
Goat cheese: Taken.
Hericot verts: Taken.
Mixed seasonal fruit: Taken.
Roasted beets: Taken.
Vanilla custard: Taken.
Balsamic dressing: Taken.
Walnuts: Taken.
Cognac butter sauce: Taken.
Whole cane sugar: Taken.
Wine cellar key: Taken.
Fine white wine: Taken.
Fine red wine: Taken.
Champagne: Taken.

>eat
What do you want to eat?

>sugar
That's plainly inedible.

* * *

>w
You can't go that way.

>e
Plating station
You can see Balsamic dressing, Walnuts, Cognac butter sauce, Whole cane sugar and a counter (on which is a final plate) here.

* * *

>take all
Sous vide ribeye: Taken.
Pomme puree: Taken.

>s
Plating station
The final place in the kitchen where the food is handled before it is sent out to the pass. This is where you will find sauces and most garnishes. there is a counter with plates where dishes can be PLATED with the correct components. There are descriptions for the roasted beet salad, ribeye, and creme brulee here. the hot station is to the north. The break room is to the east. The cold station is to the west.

You can see Balsamic dressing, Walnuts, Butter sauce, Whole cane sugar and a counter (on which is a prep plate) here.

>s
Pass
You can see a Restaurant manager and a pickup table here.

>put on table
(first taking the pickup table)
That's fixed in place.

>put pomme on table
You put Pomme puree on the pickup table.

* * *

>s
Plating station
The final place in the kitchen where the food is handled before it is sent out to the pass. This is where you will find sauces and most garnishes. there is a counter with plates where dishes can be PLATED with the correct components. There are descriptions for the roasted beet salad, ribeye, and creme brulee here. the hot station is to the north. The break room is to the east. The cold station is to the west.

You can see Balsamic dressing, Walnuts, Butter sauce, Whole cane sugar and a counter (on which is a prep plate) here.

>take all
Balsamic dressing: Taken.
Walnuts: Taken.
Butter sauce: Taken.
Whole cane sugar: Taken.

>w
cold station
The part of the kitchen where work not involving heat is done. It is also a place for prepared components of dishes to be held until they are needed. The prep station is to the north. The plating station is to the east.

You can see Roasted Beets and Vanilla custard here.

>take all
Roasted Beets: Taken.
Vanilla custard: Taken.

>n
Prep station
The prep station gets a lot of action before service starts but once service starts not a lot happens here. The Hot station is to the east. The entrance to the Walk-in is to the north. The cold station is to the south. The entrance to the Wine cellar is to the west.

I beg your pardon?

>n
Walk-in
Essentially a large closet that is a fridge. All the produce and perishables are stored here. The prep station is to the south.

You can see spring greens, Goat cheese, Hericot verts and Mixed seasonal fruit here.

>take all
spring greens: Taken.
Goat cheese: Taken.
Hericot verts: Taken.
Mixed seasonal fruit: Taken.

>s
Prep station
The prep station gets a lot of action before service starts but once service starts not a lot happens here. The Hot station is to the east. The entrance to the Walk-in is to the north. The cold station is to the south. The entrance to the Wine cellar is to the west.

>e
Hot station
The main cooking area of the kitchen. There is an eight burner gas stove on one side and a pair of commercial ovens on the other. There is a portion of pomme puree keeping warm on the stove and there is a ribeye resting on the counter. The plating station is to the south and the prep station is to the west.

>e
You can't go that way.

>s
Plating station
The final place in the kitchen where the food is handled before it is sent out to the pass. This is where you will find sauces and most garnishes. there is a counter with plates where dishes can be PLATED with the correct components. There are descriptions for the roasted beet salad, ribeye, and creme brulee here. the hot station is to the north. The break room is to the east. The cold station is to the west.

You can see a counter (on which is a prep plate) here.

>s
Pass
The area that seperates the kitchen from the dining room. It is the final stop for food before it goes to the guest. The pickup table for completed dishes is here.

You can see a Restaurant manager and a pickup table here.

>ask manager about key
"Excuse me, could I have the wine cellar key?", you ask. 

 "Here" he replies as he tosses you the key.

>n
Plating station
The final place in the kitchen where the food is handled before it is sent out to the pass. This is where you will find sauces and most garnishes. there is a counter with plates where dishes can be PLATED with the correct components. There are descriptions for the roasted beet salad, ribeye, and creme brulee here. the hot station is to the north. The break room is to the east. The cold station is to the west.

You can see a counter (on which is a prep plate) here.

>w
cold station
The part of the kitchen where work not involving heat is done. It is also a place for prepared components of dishes to be held until they are needed. The prep station is to the north. The plating station is to the east.

>w
You can't go that way.

>n
Prep station
The prep station gets a lot of action before service starts but once service starts not a lot happens here. The Hot station is to the east. The entrance to the Walk-in is to the north. The cold station is to the south. The entrance to the Wine cellar is to the west.

>w
Wine Cellar
A dimly lit room that is temperature controlled for the wine. The good stuff is kept locked in the wine case. The prep station is to the east.

>unlock wine case
What do you want to unlock Wine case with?

* * *

>key
You unlock Wine case.

>x wine case
A case made from wood and glass pannels. Inside are the best and mose expensive wines in the restaurant.

>take red wine
You can't see any such thing.

>open case
You open Wine case, revealing White wine, Fine red wine and Champagne.

>take red wine
Taken.

* * *

>take champagne
Taken.

>e
Prep station
The prep station gets a lot of action before service starts but once service starts not a lot happens here. The Hot station is to the east. The entrance to the Walk-in is to the north. The cold station is to the south. The entrance to the Wine cellar is to the west.

>s
cold station
The part of the kitchen where work not involving heat is done. It is also a place for prepared components of dishes to be held until they are needed. The prep station is to the north. The plating station is to the east.

>e
Plating station
The final place in the kitchen where the food is handled before it is sent out to the pass. This is where you will find sauces and most garnishes. there is a counter with plates where dishes can be PLATED with the correct components. There are descriptions for the roasted beet salad, ribeye, and creme brulee here. the hot station is to the north. The break room is to the east. The cold station is to the west.

You can see a counter (on which is a prep plate) here.

>put beets on plate
You put Roasted Beets on the prep plate.

>put cheese on plate
You put Goat cheese on the prep plate.

>put greens on plate
You put spring greens on the prep plate.

>put walnuts on plate
You put Walnuts on the prep plate.

* * *

>plate app
This is not a correct combination for any of the special menu dishes. 
You should try again.

>x plate
On the prep plate are Fine red wine, Walnuts, spring greens, Goat cheese and Roasted Beets.

>put balsamic on plate
You put Balsamic dressing on the prep plate.

>plate app
You put together Balsamic dressing, Fine red wine, Walnuts, spring greens, Goat cheese and Roasted Beets.

You now have a Roasted beet salad. properly plated. Now take it to the pass and put it on the pickup table!

>i
You are carrying:
  Roasted beet salad.
  Champagne
  a Wine cellar key
  Mixed seasonal fruit
  Hericot verts
  Vanilla custard
  Whole cane sugar
  Butter sauce
  Pomme puree
  Sous vide ribeye

>put pomme on plate
You put Pomme puree on the prep plate.

>put ribeye on plate
(Sous vide ribeye on the prep plate)
You put Sous vide ribeye on the prep plate.

>put verts on plate
You put Hericot verts on the prep plate.

>put sauce on plate
You put Butter sauce on the prep plate.

>plate dinner
You put together Butter sauce, Hericot verts, Sous vide ribeye and Pomme puree.

You now have a Sous vide Ribeye properly plated. Now take it to the pass and put it on the pickup table!

>put custard on plate
You put Vanilla custard on the prep plate.

>put sugar on plate
You put Whole cane sugar on the prep plate.

>put fruits on plate
You can't see any such thing.

>put fruit on pate
You can't see any such thing.

>put fruit on plate
You put Mixed seasonal fruit on the prep plate.

>put champagne on plate
You put Champagne on the prep plate.

>plate dessert
You put together Champagne, Mixed seasonal fruit, Whole cane sugar and Vanilla custard.

You now have a Vanilla creme brulee properly plated. Now take it to the pass and put it on the pickup table!

>i
You are carrying:
  Vanilla creme brulee
  Sous vide Ribeye
  Roasted beet salad.
  a Wine cellar key

>s
Pass
The area that seperates the kitchen from the dining room. It is the final stop for food before it goes to the guest. The pickup table for completed dishes is here.

You can see a Restaurant manager and a pickup table here.

>put all on pickup table
Vanilla creme brulee: Done.
Sous vide Ribeye: Done.
Roasted beet salad.: Done.
Wine cellar key: Done.

    *** good job ***

Would you like to RESTART, RESTORE a saved game, QUIT or UNDO the last command?

* * *

>n
Prep station
The prep station gets a lot of action before service starts but once service starts not a lot happens here. The Hot station is to the east. The entrance to the Walk-in is to the north. The cold station is to the south. The entrance to the Wine cellar is to the west.

>n
Walk-in
You can see Young spring greens, Goat cheese, Hericot verts and Mixed seasonal fruit here.

* * *

>s
Prep station

>w
Wine Cellar

>e
Prep station

>e
Hot station

* * *

>s
Plating station
You can see a counter (on which is a prep plate) here.

>put all on plate
Mixed seasonal fruit: Done.
Hericot verts: Done.
Goat cheese: Done.
Young spring greens: Done.
Vanilla custard: Done.
Roasted beets: Done.
Whole cane sugar: Done.
Cognac butter sauce: Done.
Walnuts: Done.
Balsamic dressing: Done.
Pomme puree: Done.
Sous vide Ribeye: Done.

>prep
That's not a verb I recognise.

>plate app
This is not a correct combination for any of the special menu dishes. 
You should try again.

>take all
Sous vide Ribeye: Taken.
Pomme puree: Taken.
Balsamic dressing: Taken.
Walnuts: Taken.
Cognac butter sauce: Taken.
Whole cane sugar: Taken.
Roasted beets: Taken.
Vanilla custard: Taken.
Young spring greens: Taken.
Goat cheese: Taken.
Hericot verts: Taken.
Mixed seasonal fruit: Taken.

>s
Pass
You can see a Restaurant manager here.

>ask manager for key
The Restaurant manager has better things to do.

>ask manager about cellar key
"Excuse me, could I have the wine cellar key?", you ask. 

 "Here" he replies as he tosses me the key.

>n
Plating station
You can see a counter (on which is a prep plate) here.

>e
Break room

>w
Plating station
You can see a counter (on which is a prep plate) here.

>w
cold station

* * *

>unlock wine case
What do you want to unlock Wine case with?

>keey
You can't see any such thing.

>key
That's not a verb I recognise.

>unlock wine case
What do you want to unlock Wine case with?

* * *

>open wine case
You open Wine case, revealing Fine white wine, Fine red wine and Champagne.

>take alll
You can't see any such thing.

>take
What do you want to take?

>champagnr
You can't see any such thing.

>take champagne
Taken.

* * *

>s
Plating station
You can see a counter (on which is a prep plate) here.

>s
Pass
You can see a Restaurant manager here.

* * *

>n
Plating station
You can see a counter (on which is a prep plate) here.

>put custard on plate
You put Vanilla custard on the prep plate.

* * *

>put sugar on plate
You put Whole cane sugar on the prep plate.

>put fruit on plate
You put Mixed seasonal fruit on the prep plate.

>plate dessert
This is not a correct combination for any of the special menu dishes. 
You should try again.

>put champagne on plate
You put Champagne on the prep plate.

>x plate
On the prep plate are Champagne, Mixed seasonal fruit, Whole cane sugar and Vanilla custard.

>plate dessert
You put together Champagne, Mixed seasonal fruit, Whole cane sugar and Vanilla custard.

You now have a dessert properly plated. Now take it to the pass!

>i
You are carrying:
  dessert
  a Wine cellar key
  Hericot verts
  Goat cheese
  Young spring greens
  Roasted beets
  Cognac butter sauce
  Walnuts
  Balsamic dressing
  Pomme puree
  Sous vide Ribeye

>put verts on plate
You put Hericot verts on the prep plate.

>put sauce on plate
You put Cognac butter sauce on the prep plate.

>put pomme on plate
You put Pomme puree on the prep plate.

>put ribeye on plate
(Sous vide Ribeye on the prep plate)
You put Sous vide Ribeye on the prep plate.

>plate dinner
This is not a correct combination for any of the special menu dishes. 
You should try again.

>x plate
On the prep plate are Sous vide Ribeye, Pomme puree, Cognac butter sauce and Hericot verts.

>plate dinner
This is not a correct combination for any of the special menu dishes. 
You should try again.

>plate dinner
This is not a correct combination for any of the special menu dishes. 
You should try again.

* * *

>x plate
On the prep plate are Sous vide Ribeye, Pomme puree, Cognac butter sauce and Hericot verts.

>x plate
On the prep plate are Sous vide Ribeye, Pomme puree, Cognac butter sauce and Hericot verts.

>plate diner
I only understood you as far as wanting to plate.

>plate dinner
This is not a correct combination for any of the special menu dishes. 
You should try again.

>x desert
You can't see any such thing.

>i
You are carrying:
  dessert
  a Wine cellar key
  Goat cheese
  Young spring greens
  Roasted beets
  Walnuts
  Balsamic dressing

>x dessert
You see nothing special about dessert.

>eat desset
You can't see any such thing.

>eat dessert
You eat dessert. Not bad.

>i
You are carrying:
  a Wine cellar key
  Goat cheese
  Young spring greens
  Roasted beets
  Walnuts
  Balsamic dressing

>undo
Plating station
[Previous turn undone.]

>i
You are carrying:
  a Wine cellar key
  Goat cheese
  Young spring greens
  Roasted beets
  Walnuts
  Balsamic dressing

* * *

>undo
Plating station
[Previous turn undone.]

>undo
Plating station
[Previous turn undone.]

>i
You are carrying:
  dessert
  a Wine cellar key
  Goat cheese
  Young spring greens
  Roasted beets
  Walnuts
  Balsamic dressing

>plate dinner
This is not a correct combination for any of the special menu dishes. 
You should try again.

* * *

>s
Plating station
The final place in the kitchen where the food is handled before it is sent out to the pass. This is where you will find sauces and most garnishes. there is a counter with plates where dishes can be PLATED with the correct components. There are descriptions for the roasted beet salad, ribeye, and creme brulee here. the hot station is to the north. The break room is to the east. The cold station is to the west.

You can see Balsamic dressing, Walnuts, Butter sauce, Whole cane sugar and a counter (on which is a prep plate) here.

>take sauce
Taken.

>n
Hot station

>e
You can't go that way.

* * *

>w
Prep station

>e
Hot station

>n
You can't go that way.

* * *

>n
Walk-in
You can see Young spring greens, Goat cheese, Hericot verts and Mixed seasonal fruit here.

>take verts
Taken.

* * *

>e
Hot station

>s
Plating station
You can see Balsamic dressing, Walnuts, Whole cane sugar and a counter (on which is a final plate) here.

>prep dinner
This is not a correct combination for any of the spacial menu dishes. 
You should try again.

>i
You are carrying:
  Hericot verts
  Cognac butter sauce
  Pomme puree
  Sous vide Ribeye

>prep
This is not a correct combination for any of the spacial menu dishes. 
You should try again.

>prep dinner on plate
I only understood you as far as wanting to prep.

>place all on counter
That's not a verb I recognise.

>i
You are carrying:
  Hericot verts
  Cognac butter sauce
  Pomme puree
  Sous vide Ribeye

>prep dinner
This is not a correct combination for any of the spacial menu dishes. 
You should try again.

>take all
Balsamic dressing: Taken.
Walnuts: Taken.
Whole cane sugar: Taken.

>w
cold station
You can see Roasted beets and Vanilla custard here.

>take all
Roasted beets: Taken.
Vanilla custard: Taken.

>n
Prep station

>n
Walk-in
You can see Young spring greens, Goat cheese and Mixed seasonal fruit here.

>take all
Young spring greens: Taken.
Goat cheese: Taken.
Mixed seasonal fruit: Taken.

>s
Prep station

* * *

>e
Hot station

>i
You are carrying:
  Mixed seasonal fruit
  Goat cheese
  Young spring greens
  Vanilla custard
  Roasted beets
  Whole cane sugar
  Walnuts
  Balsamic dressing
  Hericot verts
  Cognac butter sauce
  Pomme puree
  Sous vide Ribeye

>s
Plating station
You can see a counter (on which is a final plate) here.

>s
Pass
You can see a Restaurant manager here.

* * *

>ask manager about key
"Excuse me, could I have the wine cellar key?", you ask. 

 "Here" he replies as he tosses me the key.

>n
Plating station
You can see a counter (on which is a final plate) here.

>prep
This is not a correct combination for any of the spacial menu dishes. 
You should try again.

>prep app
This is not a correct combination for any of the spacial menu dishes. 
You should try again.

>e
Break room

>w
Plating station
You can see a counter (on which is a final plate) here.

>w
cold station

>n
Prep station

* * *

>w
Wine Cellar

>unlock case
What do you want to unlock Wine case with?

>key
You unlock Wine case.

* * *

>open wine case
You open Wine case, revealing Fine white wine, Fine red wine and Champagne.

>take red wine
Taken.

* * *

>take champagne
Taken.

>s
You can't go that way.

>e
Prep station

* * *

>e
Hot station

>s
Plating station
You can see a counter (on which is a final plate) here.

>plate app
That's not a verb I recognise.

>prep app
This is not a correct combination for any of the spacial menu dishes. 
You should try again.

>put sauce on plate
You put Cognac butter sauce on the final plate.

>put pomme on plate
You put Pomme puree on the final plate.

>put verts on plate
You put Hericot verts on the final plate.

>put rib eye on plate
You can't see any such thing.

>i
You are carrying:
  Champagne
  Fine red wine
  a Wine cellar key
  Mixed seasonal fruit
  Goat cheese
  Young spring greens
  Vanilla custard
  Roasted beets
  Whole cane sugar
  Walnuts
  Balsamic dressing
  Sous vide Ribeye

>put ribeye on plate
(Sous vide Ribeye on the final plate)
You put Sous vide Ribeye on the final plate.

>prep dinner
This is not a correct combination for any of the spacial menu dishes. 
You should try again.

>x plate
On the final plate are Sous vide Ribeye, Hericot verts, Pomme puree and Cognac butter sauce.

>prep dinner
This is not a correct combination for any of the spacial menu dishes. 
You should try again.

* * *

>n
Hot station

>w
Prep station

* * *

>s
Prep station

>d
You can't go that way.

>e
Hot station

>s
Plating station
You can see Balsamic dressing, Walnuts, Whole cane sugar and a counter (on which is a prep plate) here.

>s
Pass
You can see a Restaurant manager and a pickup table here.

>n
Plating station
You can see Balsamic dressing, Walnuts, Whole cane sugar and a counter (on which is a prep plate) here.

>put all on plate
Hericot verts: Done.
Butter sauce: Done.
Pomme puree: Done.
Sous-vide Ribeye: Done.

>plate dinner
You put together Sous-vide Ribeye, Pomme puree, Butter sauce and Hericot verts.

You now have a Sous vide Ribeye properly plated. Now take it to the pass!

>s
Pass
You can see a Restaurant manager and a pickup table here.

>place dinner on table
That's not a verb I recognise.

>put dinner on table
You put Sous vide Ribeye on the pickup table.

* * *

>s
Plating station
You can see Balsamic dressing, Walnuts, Whole cane sugar and a counter (on which is a final plate) here.

>put verts on plate
You put Hericot verts on the final plate.

>put ribeye on plate
(Sous vide Ribeye on the final plate)
You put Sous vide Ribeye on the final plate.

>put pomme on plate
You put Pomme puree on the final plate.

>put sauce on plate
You put Cognac butter sauce on the final plate.

>prep dinner
This is not a correct combination for any of the special menu dishes. 
You should try again.

>x plate
On the final plate are Cognac butter sauce, Pomme puree, Sous vide Ribeye and Hericot verts.

* * *

>take all
Sous vide ribeye: Taken.
Pomme puree: Taken.

>w
Prep station

* * *

>n
Walk-in
You can see spring greens, Goat cheese, Hericot verts and Mixed seasonal fruit here.

>take all
spring greens: Taken.
Goat cheese: Taken.
Hericot verts: Taken.
Mixed seasonal fruit: Taken.

>s
Prep station

>s
cold station
You can see Roasted Beets and Vanilla custard here.

>take all
Roasted Beets: Taken.
Vanilla custard: Taken.

>e
Plating station
You can see Balsamic dressing, Walnuts, Butter sauce, Whole cane sugar and a counter (on which is a prep plate) here.

>take all
Balsamic dressing: Taken.
Walnuts: Taken.
Butter sauce: Taken.
Whole cane sugar: Taken.

>i
You are carrying:
  Whole cane sugar
  Butter sauce
  Walnuts
  Balsamic dressing
  Vanilla custard
  Roasted-beets
  Mixed seasonal fruit
  Hericot verts
  Goat cheese
  spring greens
  Pomme puree
  Sous-vide Ribeye

>s
Pass
You can see a Restaurant manager and a pickup table here.

* * *

>ask manager about key
"Excuse me, could I have the wine cellar key?", you ask. 

 "Here" he replies as he tosses you the key.

>n
Plating station
You can see a counter (on which is a prep plate) here.

* * *

>w
Wine Cellar

>unlock wine case with key
You unlock Wine case.

>open case
You open Wine case, revealing Fine white wine, Fine red wine and Champagne.

>take red wine
Taken.

>take champage
You can't see any such thing.

>take champagne
Taken.

* * *

>s
Plating station
You can see a counter (on which is a prep plate) here.

>put wine on plate
Which do you mean, Fine red wine or the Wine cellar key?

>red wine
You put Fine red wine on the prep plate.

>put beets on plate
You can't see any such thing.

>i
You are carrying:
  Champagne
  a Wine cellar key
  Whole cane sugar
  Butter sauce
  Walnuts
  Balsamic dressing
  Vanilla custard
  Roasted-beets
  Mixed seasonal fruit
  Hericot verts
  Goat cheese
  spring greens
  Pomme puree
  Sous-vide Ribeye

>put roasted-beets on plate
You put Roasted-beets on the prep plate.

>put walnuts on plate
You put Walnuts on the prep plate.

>x plate
On the prep plate are Walnuts, Roasted-beets and Fine red wine.

>put cheese on plate
You put Goat cheese on the prep plate.

* * *

>put greens on plate
You put spring greens on the prep plate.

>put balsamic on plate
You put Balsamic dressing on the prep plate.

>plate app
This is not a correct combination for any of the special menu dishes. 
You should try again.

>x plate
On the prep plate are Balsamic dressing, spring greens, Goat cheese, Walnuts, Roasted-beets and Fine red wine.

>take all
Balsamic dressing: Taken.
spring greens: Taken.
Goat cheese: Taken.
Walnuts: Taken.
Roasted-beets: Taken.
Fine red wine: Taken.

>put pomme on pate
You can't see any such thing.

>i
You are carrying:
  Fine red wine
  Roasted-beets
  Walnuts
  Goat cheese
  spring greens
  Balsamic dressing
  Champagne
  a Wine cellar key
  Whole cane sugar
  Butter sauce
  Vanilla custard
  Mixed seasonal fruit
  Hericot verts
  Pomme puree
  Sous-vide Ribeye

>put pomme on plate
You put Pomme puree on the prep plate.

>put ribeye on plate
(Sous-vide Ribeye on the prep plate)
You put Sous-vide Ribeye on the prep plate.

>put verts on plate
You put Hericot verts on the prep plate.

* * *

>put sauce on plate
You put Butter sauce on the prep plate.

>plate dinner
You put together Butter sauce, Hericot verts, Sous-vide Ribeye and Pomme puree.

You now have a Sous vide Ribeye properly plated. Now take it to the pass!

>put custard on plate
You put Vanilla custard on the prep plate.

>put fruit on plate
You put Mixed seasonal fruit on the prep plate.

>put champagne on plte
You can't see any such thing.

>put champage on plate
You can't see any such thing.

>put champagne on plate
You put Champagne on the prep plate.

>put sugar on plate
You put Whole cane sugar on the prep plate.

>plate dessert
You put together Whole cane sugar, Champagne, Mixed seasonal fruit and Vanilla custard.

You now have a Vanilla creme brulee properly plated. Now take it to the pass!

* * *

>take all
Balsamic dressing: Taken.
Walnuts: Taken.
Butter sauce: Taken.
Whole cane sugar: Taken.

>s
Pass
You can see a Restaurant manager and a pickup table here.

>ask about key
You can't see any such thing.

>ask manager about key
"Excuse me, could I have the wine cellar key?", you ask. 

 "Here" he replies as he tosses you the key.

* * *

>open case
You open Wine case, revealing Fine white wine, Fine red wine and Champagne.

>take red wine
You can't see any such thing.

>take fine red wine
I only understood you as far as wanting to take Fine white wine.

>take wine
(Fine white wine)
Taken.

>take
What do you want to take?

>fine
You already have that.

>take fineredwine
Taken.

>i
You are carrying:
  Fine red wine
  Fine white wine
  a Wine cellar key
  Whole cane sugar
  Butter sauce
  Walnuts
  Balsamic dressing
  Vanilla custard
  Roasted Beets
  Mixed seasonal fruit
  Hericot verts
  Goat cheese
  spring greens
  Pomme puree
  Sous vide ribeye

>drop white wine
Dropped.

>take champagne
Taken.

* * *

>e
Plating station
You can see a counter (on which is a prep plate) here.

>put beets on plate
You can't see any such thing.

>i
You are carrying:
  Champagne
  Fine red wine
  a Wine cellar key
  Whole cane sugar
  Butter sauce
  Walnuts
  Balsamic dressing
  Vanilla custard
  Roasted Beets
  Mixed seasonal fruit
  Hericot verts
  Goat cheese
  spring greens
  Pomme puree
  Sous vide ribeye

>put roasted-beets on plate
You put Roasted Beets on the prep plate.

>put walnuts on plate
You put Walnuts on the prep plate.

>put balsamic on plate
You put Balsamic dressing on the prep plate.

>put cheese on plate
You put Goat cheese on the prep plate.

* * *

>put greens on plate
You put spring greens on the prep plate.

>x plat e
You can't see any such thing.

>x plate
On the prep plate are spring greens, Goat cheese, Balsamic dressing, Walnuts and Roasted Beets.

>put fineredwine on plate
You put Fine red wine on the prep plate.

>plate app
You put together Fine red wine, spring greens, Goat cheese, Balsamic dressing, Walnuts and Roasted Beets.

You now have a Roasted beet salad. properly plated. Now take it to the pass!

>put ribeye on plate
(Sous vide ribeye on the prep plate)
You put Sous vide ribeye on the prep plate.

>put pomme on plate
You put Pomme puree on the prep plate.

>put verts on plate
You put Hericot verts on the prep plate.

>x plate
On the prep plate are Hericot verts, Pomme puree and Sous vide ribeye.

>put sauce on plate
You put Butter sauce on the prep plate.

>plate dinner
You put together Butter sauce, Hericot verts, Pomme puree and Sous vide ribeye.

You now have a Sous vide Ribeye properly plated. Now take it to the pass!

>put all on plat e
You can't see any such thing.

>i
You are carrying:
  Sous vide Ribeye
  Roasted beet salad.
  Champagne
  a Wine cellar key
  Whole cane sugar
  Vanilla custard
  Mixed seasonal fruit

>put fruit on plate
You put Mixed seasonal fruit on the prep plate.

>put custard on plate
You put Vanilla custard on the prep plate.

* * *

>put sugar on plate
You put Whole cane sugar on the prep plate.

>put champagne on plate
You put Champagne on the prep plate.

>plate dessert
You put together Champagne, Whole cane sugar, Vanilla custard and Mixed seasonal fruit.

You now have a Vanilla creme brulee properly plated. Now take it to the pass!

>s
Pass
You can see a Restaurant manager and a pickup table here.

>put app on table
You put Roasted beet salad. on the pickup table.

>put dinner on table
You put Sous vide Ribeye on the pickup table.

>put dessert on table
You put Vanilla creme brulee on the pickup table.

    *** good job ***

Would you like to RESTART, RESTORE a saved game, QUIT or UNDO the last command?

* * *

>n
Walk-in
You can see spring greens, Goat cheese, Hericot verts and Mixed seasonal fruit here.

>take vert
You can't see any such thing.

>take verts
Taken.

* * *

>e
Plating station
You can see Balsamic dressing, Walnuts, Butter sauce, Whole cane sugar and a counter (on which is a prep plate) here.

>take sauce
Taken.

>i
You are carrying:
  Butter sauce
  Hericot verts
  Pomme puree
  Sous-vide Ribeye

>put all on plate
Butter sauce: Done.
Hericot verts: Done.
Pomme puree: Done.
Sous-vide Ribeye: Done.

>plate dinner
You put together Sous-vide Ribeye, Pomme puree, Hericot verts and Butter sauce.

You now have a dinner properly plated. Now take it to the pass!

>i
You are carrying:
  dinner

>s
Pass
You can see a Restaurant manager here.

>put dinner on tabel
You can't see any such thing.

>put dinner on table
Putting things on the pickup table would achieve nothing.

* * *

>take verts
Taken.

>take all e
You can't see any such thing.

>s
Prep station

* * *

>put all on plate
Butter sauce: Done.
Hericot verts: Done.
Pomme puree: Done.
Sous-vide Ribeye: Done.

>plate dinne
I only understood you as far as wanting to plate.

>plate dinner
You put together Sous-vide Ribeye, Pomme puree, Hericot verts and Butter sauce.

You now have a Sous vide Ribeye properly plated. Now take it to the pass!

>x dinner
A sous vide prime grade ribeye served alongside pomme puree and hericot verts. With a congac butter sauce drizzled on top.

* * *

>n
Walk-in
You can see spring greens, Goat cheese, Hericot verts and Mixed seasonal fruit here.

>take vets
You can't see any such thing.

>take verts
Taken.

* * *

>take sauce
Taken.

>s
Pass
You can see a Restaurant manager here.

>n
Plating station
You can see Balsamic dressing, Walnuts, Whole cane sugar and a counter (on which is a prep plate) here.

>put all on plate
Butter sauce: Done.
Hericot verts: Done.
Pomme puree: Done.
Sous vide Ribeye: Done.

>plate dinner
This is not a correct combination for any of the special menu dishes. 
You should try again.

* * *

>w
Wine Cellar

* * *

>e
Prep station

>w
Wiine Cellar

>e
Prep station

>we
That's not a verb I recognise.

>w
Wiine Cellar

>w
You can't go that way.

>e
Prep station

* * *

>w
Wine Cellar

>open case
It seems to be locked.

>w
You can't go that way.

I beg your pardon?

>s
You can't go that way.

* * *

>e
Prep station

>e
Hot station
You can see Sous vide Ribeye and Pomme puree here.

* * *

>n
Hot station
You can see Sous vide Ribeye and Pomme puree here.

>n
You can't go that way.

* * *

>w
Wine Cellar

>unlock case
(with the Wine cellar key)
You unlock Wine case.

>open case
You open Wine case.

* * *

>x
What do you want to examine?

>room
You can't see any such thing.

>x prep station
You can't see any such thing.

>x Prep station
You can't see any such thing.

>e
Hot station
You can see Sous vide Ribeye and Pomme puree here.

>x pomme
Pomme puree: essentialy mashed potatoes.

>x sous
A 12oz ribeye steak cooked to a perfect medium rare.

>e
You can't go that way.

* * *

>s
cold station
You can see Roasted beets and Vanilla custard here.

>x beets
A mixture of multi-colored beets that have been roasted in the oven.

* * *

>x me
 you look good

* * *

>x pomme
Pomme puree: essentialy mashed potatoes.

* * *

>x stove
An eight burner gas stove. It is top of the line and an essential part of the kitchen.